3,2,2,2,2,2,2,2,2,6
9,8,8,8,0,8,8,8,8,12
3,2,2,2,4,3,2,2,2,6
1,0,0,0,4,1,0,0,0,4
1,0,0,0,0,0,0,0,0,4
1,0,0,0,0,0,0,0,0,4
1,0,0,0,4,1,0,0,0,4
1,0,0,0,4,1,0,0,0,4
1,0,0,0,0,0,0,0,0,4
9,8,8,8,8,8,8,8,8,12
